20 12
TTTTTTTTTTTTTTTTTTTT
TRPPPPPWPPPDDDDDDWET
TWWWWWPWDWPWWWWWDWDT
TDDDDDDWPWPBDDDWDWDT
TPWWWWWWPWWWDWDWDWDT
TDDDDDDDDWDWDWDWDWDT
TPPPPPPPDWDWDWDWDWDT
TPPPPPPPDWDWDWDWDWDT
TPPPPPPPDWDWDWDDDWDT
TPAPPPPPDDDWDWWWWWDT
TPPPPFPPDDDWDPDDDDDT
TTTTTTTTTTTTTTTTTTTT
-
D 2
