11 12
TTTTTTTTTTT
TDPPPPPUPPT
TDPPPPPPPPT
TDPPPPPPPPT
TDPPPPPPPPT
TDPPPPPPPPT
TDPPP@PPPPT
TDPPPPPPPPT
TDPPPPPPPPT
TDPPPPPPRPT
TDPPPPPPPPT
TTTTTTTTTTT
-
D 2