20 12
TTTTTTTTTTTTTTTTTTTT
TPPPPPPPPWPPPPPPPPPT
TPFPPPPPPPGPPPPPDPPT
TPPPPWWPPPPWPPPPDPPT
TPPPPWWPPPPPWPPPDPPT
TPPPPPPPPPPPPWPPDDDT
TPRPPPPPPPPPPDPPPPPT
TPPPPWWPPPPPWPPPPPPT
TPPPPWWPPPPWPPPPPPPT
TPPPPPPPDDWPPPPPPPPT
TPPPPPPPPWPPPPPPPPET
TTTTTTTTTTTTTTTTTTTT
-
D 2
