TIME:14
DIAMONDS:10
AMOEBA_LIMIT:20
AMOEBA_RATE:5

44  25
TTTTTTTTTTTTTTTTTTTTTTTTTTTTTTTTTTTTTTTTTTTT
TRPPPPTPPBPPBPTTTTTTTTTTTTTTTTTTTTTTTTTTTTTT
TPP!PPTDDDDDDDTTTTTTTTTTTTTTTTTTTTTTTTTTTTTT
TPPPPPTPWPWPPPTTTTTTTTTTTTTTTTTTTTTTTTTTTTTT
TTT1TTTPWPWPGPTTTTTTTTTTTTTTTTTTTTTTTTTTTTTT
T"PPPP2PWFWPPPTTTTTTTTTTTTTTTTTTTTTTTTTTTTTT
TPPPPPTWWWWPPPTTTTTTTTTTTTTTTTTTTTTTTTTTTTTT
TPPWSPTPPAPPPPTTTTTTTTTTTTTTTTTTTTTTTTTTTTTT
TPWPWPTPPPPPPPTTTTTTTTTTTTTTTTTTTTTTTTTTTTTT
TPPPPPTPPPPPPPTTTTTTTTTTTTTTTTTTTTTTTTTTTTTT
TTTTTTTTTTTTTTTTTTTTTTTTTTTTTTTTTTTTTTTTTTTT
TTTTTTTTTTTTTTTTTTTTTTTTTTTTTTTTTTTTTTTTTTTT
TTTTTTTTTTTTTTTTTTTTTTTTTTTTTTTTTTTTTTTTTTTT
TTTTTTTTTTTTTTTTTTTTTTTTTTTTTTTTTTTTTTTTTTTT
TTTTTTTTTTTTTTTTTTTPOOOOFTTTTTTTTTTTTTTTTTTT
TTTTTTTTTTTTTTTTTTTPWWWWPTTTTTTTTTTTTTTTTTTT
TTTTTTTTTTTTTTTTTTTPOOOOPTTTTTTTTTTTTTTTTTTT
TTTTTTTTTTTTTTTTTTTPWWWWPTTTTTTTTTTTTTTTTTTT
TTTTTTTTTTTTTTTTTTTPPPPPPTTTTTTTTTTTTTTTTTTT
TTTTTTTTTTTTTTTTTTTPWWWWPTTTTTTTTTTTTTTTTTTT
TTTTTTTTTTTTTTTTTTTPOOOOPTTTTTTTTTTTTTTTTTTT
TTTTTTTTTTTTTTTTTTTPWWWWPTTTTTTTTTTTTTTTTTTT
TTTTTTTTTTTTTTTTTTTPPPPRPTTTTTTTTTTTTTTTTTTT
TTTTTTTTTTTTTTTTTTTETTTTTTTTTTTTTTTTTTTTTTTT
-
D 2