20 12
DDDDDDDDDDDDDDDDDDDD
DPPPPPPPPWPPPPPPPPPD
DPPPPPPPPPWPPPPPPPPD
DPPPPWWPPPPWPPPPPPPD
DPPPPWWPPPPPWPPPPPPD
DPPPPPPPPPPPPWPPPPPD
DPRPPPPPPPPPPWPPPPPD
DPPPPWWPPPPPWPPPPPPD
DPPPPWWPPPPWPPPPPPPD
DPPPPPPPPPWPPPPPPPPD
DPPPPPPPPWPPPPPPPPPD
DDDDDDDDDDDDDDDDDDDD
-
D 2
