TIME:14
DIAMONDS:10
AMOEBA_LIMIT:20
AMOEBA_RATE:5

44  25
TTTTTTTTTTTTTTTTTTTTTTTTTTTTTTTTTTTTTTTTTTTT
TTTTTTTTTTTTTTTTTTTTTTTTTTTTTTTTTTTTTTTTTTTT
TTTTTTTTTTTTTTTTTTTTTTTTTTTTTTTTTTTTTTTTTTTT
TTTTTTTTTTTTTTTTTTTPOOOOFTTTTTTTTTTTTTTTTTTT
TTTTTTTTTTTTTTTTTTTPWWWWPTTTTTTTTTTTTTTTTTTT
TTTTTTTTTTTTTTTTTTTPOOOOPTTTTTTTTTTTTTTTTTTT
TTTTTTTTTTTTTTTTTTTPWWWWPTTTTTTTTTTTTTTTTTTT
TTTTTTTTTTTTTTTTTTTPPPPPPTTTTTTTTTTTTTTTTTTT
TTTTTTTTTTTTTTTTTTTPWWWWPTTTTTTTTTTTTTTTTTTT
TTTTTTTTTTTTTTTTTTTPOOOOPTTTTTTTTTTTTTTTTTTT
TTTTTTTTTTTTTTTTTTTPWWWWPTTTTTTTTTTTTTTTTTTT
TTTTTTTTTTTTTTTTTTTPPPPRPTTTTTTTTTTTTTTTTTTT
TTTTTTTTTTTTTTTTTTTETTTTTTTTTTTTTTTTTTTTTTTT
TTTTTTTTTTTTTTTTTTTTTTTTTTTTTTTTTTTTTTTTTTTT
TTTTTTTTTTTTTTTTTTTTTTTTTTTTTTTTTTTTTTTTTTTT
TTTTTTTTTTTTTTTTTTTTTTTTTTTTTTTTTTTTTTTTTTTT
TTTTTTTTTTTTTTTTTTTTTTTTTTTTTTTTTTTTTTTTTTTT
TTTTTTTTTTTTTTTTTTTTTTTTTTTTTTTTTTTTTTTTTTTT
TTTTTTTTTTTTTTTTTTTTTTTTTTTTTTTTTTTTTTTTTTTT
TTTTTTTTTTTTTTTTTTTTTTTTTTTTTTTTTTTTTTTTTTTT
TTTTTTTTTTTTTTTTTTTTTTTTTTTTTTTTTTTTTTTTTTTT
TTTTTTTTTTTTTTTTTTTTTTTTTTTTTTTTTTTTTTTTTTTT
TTTTTTTTTTTTTTTTTTTTTTTTTTTTTTTTTTTTTTTTTTTT
TTTTTTTTTTTTTTTTTTTTTTTTTTTTTTTTTTTTTTTTTTTT
-
D 2