20 12
TTTTTTTTTTTTTTTTTTTT
TPPPPPPPPWPPPPPPPPPT
TPFPPPPPPPGPPPPPPPPT
TPPPPWWPPPPWPPPPPPPT
TPPPPWWPPPPPWPPPPPPT
TPPPPPPPPPPPPWPPPPPT
TPRPPPPPPPPPPDPPPPPT
TPPPPWWPPPPPWPPPPPPT
TPPPPWWPPPPWPPPPPPPT
TPPPPPPPDDWPPPPPPPPT
TPPPPPPPPWPPPPPPPPET
TTTTTTTTTTTTTTTTTTTT
-
D 2
