15   12
TTTTTTTTTTTTTTT
TOWBDDWDBPPFTET
TPWPWDWDWWPPTDT
TPWPWDWDWWWPTDT
TGWGWDWDPPPPTDT
TPWPWDWDPPUPTDT
TAWPWDDPPWGWTDT
TPWPWDWPPPPPTDT
TPWPWDWDDDDDPDT
TPWPWDWOOOOOTDT
TPWPWRWOOOOOTDT
TTTTTTTTTTTTTTT
-
D 2