TIME:14
DIAMONDS:5
AMOEBA_LIMIT:3
AMOEBA_RATE:5

44  25
TPDWTGE!"£$1234RTBOUSF@NATTTTTTTTTTTTTTTTTTT
TTTTTTTTTTTTTTTPTTTTTTTTTTTTTTTTTTTTTTTTTTTT
TPPPPPP!"£$PPPPPPPPPPPPPPPPPPPPPPPPPPPPPPPPT
TPPPPPPPPPPPPPPPPPPPPPPPPPPPPPPPPPPPPPPPPPPT
TPPTTTTTTTT1TTTTTTTTTTTTTTTTTTTT2TTTTTTTTPPT
TPPTPPPPPPPPPPPPPPPPPTTPPPPPPPPPPPPPPPPPTPPT
TPPTPPPPPPPPPPPPPPPPPTTPPPPPPPPPPPPPPPPPTPPT
TPPTPPPPPPPNFPPPPPPPPTTPPPPPPPPPPPPPPPPPTPPT
TPP1PPPUPPPPPPPPPSPPP12PPPPPPPPPPPPPPPPP2PPT
TPPTPPWWWPPPPPPPWWWPPTTPPPPPPPPPPPPPPPPPTPPT
TPPTPPPPPPPPPPPPPPPPPTTPPPPPPPPPPPPPPPPPTPPT
TPPTPPPPPPPPPPPPPPPPPTTPPPPPPPPPPPPPPPPPTPPT
TPPTTTTTTTT1TTTTTTTTTTTTTTTTTTTT2TTTTTTTTPPT
TPPTTTTTTTT3TTTTTTTTTTTTTTTTTTTT4TTTTTTTTPPT
TPPTPPPPPPPPPPPPPPPPPTTPPPPPPPPPPPPPPPPPTPPT
TPPTPPPPPPPPPPPPPPPPPTTPPPPPPPPPPPPPPPPPTPPT
TPPTPPPPPPPPPPPPPPPPPTTPPPPPPPPPPPPPPPPPTPPT
TPP3PPPPPPPPPPPPPPPPP34PPPPPPPPPPPPPPPPP4PPT
TPPTPPPPPPPPPPPPPPPPPTTPPPPPPPPPPPPPPPPPTPPT
TPPTPPPPPPPPPPPPPPPPPTTPPPPPPPPPPPPPPPPPTPPT
TPPTPPPPPPPPPPPPPPPPPTTPPPPPPPPPPPPPPPPPTPPT
TPPTTTTTTTT3TTTTTTTTTTTTTTTTTTTTTTTTTTTTTPPT
TPPPPPPPPPPPPPPPPPPPPPPPPPPPPPPPPPPPPPPPPPPT
TPPPPPPPPPPPPPPPPPPPPPPPPPPPPPPPPPPPPPPPPPPT
TTTTTTTTTTTTTTTTTTTTTTTTTTTTTTTTTTTTTTTTTTTT
-
D 2