TIME:600
DIAMONDS:5
AMOEBA_LIMIT:3
AMOEBA_RATE:5

44  25
TPDWTG!"£$1234ERTBOUSF@NATTTTTTTTTTTTTTTTTTT
TTTTTTTTTTTTTTTPTTTTTTTTTTTTTTTTTTTTTTTTTTTT
TPPPPPP!"£$PPPPPPPPPPPPPPPPPPPPPPPPPPPPPPPPT
TPPPPPPPPPPPPPPPPPPPPPPPPPPPPPPPPPPPPPPPPPPT
TPPTTTTTTTTT1TTTTTTTTTTTTTTTTTT2TTTTTTTTTPPT
TPPTPPPPPPPPPPPWP@PW@TTPPBPPPPPPPPPPPPPPTPPT
TPPTPPPPPPPPPPPWPPPWPTTBPDBPPPBPBPBPPPPPTPPT
TPPTPPPPPPPNFPPWWWWWWTTWDGWWPDDDDDDDPPPPTPPT
TPP1PPPUPPPPPPPPPSPPP12PPPPPPTPTPTPTPPPP2PPT
TPPTPPWWWPPPPPPPWWWPPTTPPPPPPTFGUGSTPPPPTPPT
TPPTPPPPPPPPPPPPPPPPPTTPPPPPPWTWTWTWPPPPTPPT
TPPTPPPPPPPPPPPPPPPPPTTPPPPPPPPPPPPPPPPPTPPT
TPPTTTTTTTTT1TTTTTTTTTTTTTTTTTT2TTTTTTTTTPPT
TPPTTTTTTTTT3TTTTTTTTTTTTTTTTTT4TTTTTTTTTPPT
TPPTPPOPPPPPPPPPPPPPPTTPPPPPPPPPPPPPPPPPTPPT
TPPTOPDOPPPOPOPOPPPPPTTPPPPPPPPPPPPPPPPPTPPT
TPPTWDGWWPDDDDDDDPPPPTTPPPPPPPPPPPPPPPPPTPPT
TPP3PPPPPPTPTPTPTPPPP34PPPPPPPPPPPPPPPPP4PPT
TPPTPPPPPPTFGUGSTPPPPTTPPPPPPPPPPPPPPPPPTPPT
TPPTPPPPPPWTWTWTWPPPPTTPPAPPPPPPPPPPPPPPTPPT
TPPTPPPPPPPPPPPPPPPPPTTPPPPPPPPPPPPPPPPPTPPT
TPPTTTTTTTTT3TTTTTTTTTTTTTTTTTT4TTTTTTTTTPPT
TPPPPPPPPPPPPPPPPPPPPPPPPPPPPPPPPPPPPPPPPPPT
TPPPPPPPPPPPPPPPPPPPPPPPPPPPPPPPPPPPPPPPPPPT
TTTTTTTTTTTTTTTTTTTTTTTTTTTTTTTTTTTTTTTTTTTT
-
D 2
