TIME:30
DIAMONDS:5
AMOEBA_LIMIT:20
AMOEBA_RATE:5

44  25
TTTTTTTTTTTTTTTTTTTTTTTTTTTTTTTTTTTTTTTTTTTT
TTTTTTTTTTTTTTTTTTTTTTTTTTTTTTTTTTTTTTTTTTTT
TTTTTTTTTTTTTTTTTTTTTTTTTTTTTTTTTTTTTTTTTTTT
TTTTTTTTTTTTTTTTTTTTTTTTTTTTTTTTTTTTTTTTTTTT
TTTTTTTTTTTTTTTTTTTTTTTTTTTTTTTTTTTTTTTTTTTT
TTTTTTTTTTTTTTTTTTTTTTTTTTTTTTTTTTTTTTTTTTTT
TTTTTTTTTTTTTTTTTTTTTTTTTTTTTTTTTTTTTTTTTTTT
TTTTTTTTTTTTTTTTTTRDPBNDPOTTTTTTTTTTTTTTTTTT
TTTTTTTTTTTTTTTTTTPOPWBDPBTTTTTTTTTTTTTTTTTT
TTTTTTTTTTTTTTTTTTPDWDPDDDTTTTTTTTTTTTTTTTTT
TTTTTTTTTTTTTTTTTTWDPDWOPDTTTTTTTTTTTTTTTTTT
TTTTTTTTTTTTTTTTTTPDPDPDPDTTTTTTTTTTTTTTTTTT
TTTTTTTTTTTTTTTTTTP@PDWDFDTTTTTTTTTTTTTTTTTT
TTTTTTTTTTTTTTTTTTPWPDPDPDTTTTTTTTTTTTTTTTTT
TTTTTTTTTTTTTTTTTTUDODADPDTTTTTTTTTTTTTTTTTT
TTTTTTTTTTTTTTTTTTEDPDPDPBTTTTTTTTTTTTTTTTTT
TTTTTTTTTTTTTTTTTTTTTTTTTTTTTTTTTTTTTTTTTTTT
TTTTTTTTTTTTTTTTTTTTTTTTTTTTTTTTTTTTTTTTTTTT
TTTTTTTTTTTTTTTTTTTTTTTTTTTTTTTTTTTTTTTTTTTT
TTTTTTTTTTTTTTTTTTTTTTTTTTTTTTTTTTTTTTTTTTTT
TTTTTTTTTTTTTTTTTTTTTTTTTTTTTTTTTTTTTTTTTTTT
TTTTTTTTTTTTTTTTTTTTTTTTTTTTTTTTTTTTTTTTTTTT
TTTTTTTTTTTTTTTTTTTTTTTTTTTTTTTTTTTTTTTTTTTT
TTTTTTTTTTTTTTTTTTTTTTTTTTTTTTTTTTTTTTTTTTTT
-
D 2