TIME:300
DIAMONDS:5
AMOEBA_LIMIT:20
AMOEBA_RATE:5

44  25
TTTTTTTTTTTTTTTTTTTTTTTTTTTTTTTWTTTTTTTTTTTT
TTTTTTTTTTTTTTTTTTTTTTTTTTTTTTTWTTTTTTTTBTBT
TTTTTTTTTTTTTTDT!TOOPPPPPPTPPPTWTTTTTTTTATPT
TTTTTTTTTTTTTTRTDTPPPTTTTPTPPPTWTTTTTTTTATPT
TTTTTTTTTTTTTTDTDTTTTTPPPPTPPPTWTTTTTTTTATPT
TTTTTTTTTTTTTTDTDTBAPTDTTTTPPPTWTTTTTTTTATPT
TTTTTTTTTTTTTTDDD1PPP2PPPPTPPPTWTTTTTTTTATPT
TTTTTTTTTTTTTTTTTTPPPTPPPPTPPPTWTTTTTTTTATPT
TTTTTTTTTTTTTTBPBTPPPTPPPPTPPPTWTTTTTTTTTTTT
TTTTTTTTTTTTTTWPWTWWPTPPPPTPPPTWTTTTTTTTTTTT
TTTTTTTTTTTTTTWUWT"PPTPPPPTPPPTWTTTTTTTTTTTT
TTTTTTTTTTTTTTTTTTTTTTPPPPTPPPTWTTTTTTTTTTTT
TTTTTTTTTTTTTT@PTPPPPPPPPPTPPPTWTTTTTTTTTTTT
TTTTTTTTTTTTTTPPTPPPPPPPPPTPPPTWTTTTTTTTTTTT
TTTTTTTTTTTTTTTTTPPPPPPSPPTPPPTWTTTTTTTTTTTT
TTTTTTTTTTTTTTPPTPPPPPTTTPTPPPTWTTTTTTTTTTTT
TTTTTTTTTTTTTTPP3PPPPPPPPPTPPPTWTTTTTTTTTTTT
TTTTTTTTTTTTTTEPTPPPPPP£PPTPP@TWTTTTTTTTTTTT
TTTTTTTTTTTTTTTTTTTTTTTTTTTTTTTWTTTTTTTTTTTT
TTTTTTTTTTTTTTTTTTTTTTTTTTTTTTTWTTTTTTTTTTTT
TTTTTTTTTTTTTTTTTTTTTTTTTTTTTTTWTTTTTTTTTTTT
TTTTTTTTTTTTTTTTTTTTTTTTTTTTTTTWTTTTTTTTTTTT
TTTTTTTTTTTTTTTTTTTTTTTTTTTTTTTWTTTTTTTTTTTT
TTTTTTTTTTTTTTTTTTTTTTTTTTTTTTTWTTTTTTTTTTTT
-
D 2