20 12
TTTTTTTTTTTTTTTTTTTT
TFPPPPPPPWPPPPPPPPPT
TPPPPPPPPPGPPPPPPPPT
TPPPPWWPPPPWPPPPPPPT
TPPPPWWPPPPPWPPPPPPT
TPPPPPPPPPPPPWPPPPPT
TPRPPPPPPPPPPDPPPPPT
TPPPPWWPPPPPWPPPPPPT
TPPPPWWPPPPWPPPPPPPT
TPPPPPPPDDWPPPPPPPPT
TPPPPPPPPWPPPPPPPPET
TTTTTTTTTTTTTTTTTTTT
-
D 2
