TIME:14
DIAMONDS:5
AMOEBA_LIMIT:3
AMOEBA_RATE:5

22  11
TTTTTTTTTTTTTTTTTTTTTT
TRPPPPTPPBPPBPTTTTTTTT
TPP!PPTDDDDDDDTTTTTTTT
TPPPPPTPWPWPPPTTTTTTTT
TTT1TTTPWPWPGPTTTTTTTT
T"PPPP2PWFWPPPTTTTTTTT
TPPPPPTWWWWPPPTTTTTTTT
TPPWSPTPPAPPPPTTTTTTTT
TPWPWPTPPPPPPPTTTTTTTT
TPPPPPTPPPPPPPTTTTTTTT
TTTTTTTTTTTTTTTTTTTTTT
-
D 2