20 12
TTTTTTTTTTTTTTTTTTTT
TRPPPPPWPPPDDDDDDWET
TWWWWWPWDWPWWWWWDWDT
TDDDDDDWPWPBDDDWDWDT
TPWWWWWWPWWWDWDWDWDT
TAAAAAAADWDWDWDWDWDT
TPPPPPPPDWDWDWDWDWDT
TPPPPPPPDWDWDWDWDWDT
TPPPPPPPDWDWDWDDDWDT
TPPPPPPPDDDWDWWWWWDT
TPPPPPPPDDDWDPDDDDDT
TTTTTTTTTTTTTTTTTTTT
-
D 2
