TIME:14
DIAMONDS:5
AMOEBA_LIMIT:20
AMOEBA_RATE:5

44  25
TTTTTTTTTTTTTTTTTTTTTTTTTTTTTTTWTTTTTTTTTTTT
TTTTTTTTTTTTTTTTTTTTTTTTTTTTTTTWTTTTTTTTTTTT
TTTTTTTTTTTTTTDT!TFPPPPPPPTPPPTWTTTTTTTTTTTT
TTTTTTTTTTTTTTRTDTPPPTTTTPTPPPTWTTTTTTTTTTTT
TTTTTTTTTTTTTTDTDTTTTTPPPPTPPPTWTTTTTTTTTTTT
TTTTTTTTTTTTTTDTDTBAPTDTTTTPPPTWTTTTTTTTTTTT
TTTTTTTTTTTTTTDDD1PPP2PPPPTPPPTWTTTTTTTTTTTT
TTTTTTTTTTTTTTTTTTPPPTPPPPTPPPTWTTTTTTTTTTTT
TTTTTTTTTTTTTTBPBTPPPTPPPPTPPPTWTTTTTTTTTTTT
TTTTTTTTTTTTTTWPWTWWPTPPPPTPPPTWTTTTTTTTTTTT
TTTTTTTTTTTTTTWUWT"PPTPPPPTPPPTWTTTTTTTTTTTT
TTTTTTTTTTTTTTTTTTTTTTPPPPTPPPTWTTTTTTTTTTTT
TTTTTTTTTTTTTT@PTPPPPPPPPPTPPPTWTTTTTTTTTTTT
TTTTTTTTTTTTTTPPTPPPPPPPPPTPPPTWTTTTTTTTTTTT
TTTTTTTTTTTTTTTTTPPPPPPSPPTPPPTWTTTTTTTTTTTT
TTTTTTTTTTTTTTPPTPPPPPTTTPTPPPTWTTTTTTTTTTTT
TTTTTTTTTTTTTTPP3PPPPPPPPPTPPPTWTTTTTTTTTTTT
TTTTTTTTTTTTTTEPTPPPPPP£PPTPP@TWTTTTTTTTTTTT
TTTTTTTTTTTTTTTTTTTTTTTTTTTTTTTWTTTTTTTTTTTT
TTTTTTTTTTTTTTTTTTTTTTTTTTTTTTTWTTTTTTTTTTTT
TTTTTTTTTTTTTTTTTTTTTTTTTTTTTTTWTTTTTTTTTTTT
TTTTTTTTTTTTTTTTTTTTTTTTTTTTTTTWTTTTTTTTTTTT
TTTTTTTTTTTTTTTTTTTTTTTTTTTTTTTWTTTTTTTTTTTT
TTTTTTTTTTTTTTTTTTTTTTTTTTTTTTTWTTTTTTTTTTTT
-
D 2