15   12
TTTTTTTTTTTTTTT
TBWDDDWDBPPFTET
TRWAWDWDWWPPTDT
TAWAWDWDWWWPTDT
TAWAWDWDPPPPTDT
TAWAWDWDPPUPTDT
TAWAWDDPPWGWTDT
TAWAWDWPPPPPTDT
TAWAWDWDDDDDPDT
TPWPWDWOOOOOTDT
TPPPWDWOOOOOTDT
TTTTTTTTTTTTTTT
-
D 2