20 12
TTTTTTTTTTTTTTTTTTTT
TPPPPPPPPWPPPPPPPPPT
TPPPPPPPPPGPPPPPPPPT
TPPPPWWPPPPWPPPPPPPT
TPPPPWWPPPPPWPPPPPPT
TPPPPPPPPPPPPWPPPPPT
TPRPPPPPPPPPPWPPPPPT
TPPPPWWPPPPPWPPPPPPT
TPPPPWWPPPPWPPPPPPPT
TPPPPPPPDDWPPPPPPPPT
TPPPPPPPPWPPPPPPPPET
TTTTTTTTTTTTTTTTTTTT
-
D 2
